* **** *****
*#* #*  #  *
  *   & **  
*#* **   ***
* * *  *   *
*#  ****** *
  * #   #  *
****** *****