* **** *****
* *  *     *
        **  
* * **    **
*   *   *  *
*   ****** *
  *      *  
****** *****